{
    "version": 1,
    "notes": "",
    "documentation": "\"This file is a QMK Configurator export. You can import this at <https://config.qmk.fm>. It can also be used directly with QMK's source code.\n\nTo setup your QMK environment check out the tutorial: <https://docs.qmk.fm/#/newbs>\n\nYou can convert this file to a keymap.c using this command: `qmk json2c {keymap}`\n\nYou can compile this keymap using this command: `qmk compile {keymap}`\"\n",
    "keyboard": "bastardkb/charybdis/4x6/v2/splinky_3",
    "keymap": "flo",
    "layout": "LAYOUT",
    "layers": [
        [
            "XXXXXXX",
            "XXXXXXX",
            "XXXXXXX",
            "XXXXXXX",
            "XXXXXXX",
            "XXXXXXX",
            "XXXXXXX",
            "XXXXXXX",
            "XXXXXXX",
            "XXXXXXX",
            "XXXXXXX",
            "XXXXXXX",
            "XXXXXXX",
            "KC_W",
            "KC_L",
            "KC_Y",
            "KC_P",
            "KC_B",
            "KC_Z",
            "KC_F",
            "KC_O",
            "KC_U",
            "KC_QUOT",
            "XXXXXXX",
            "XXXXXXX",
            "LCTL_T(KC_C)",
            "LALT_T(KC_R)",
            "LGUI_T(KC_S)",
            "LSFT_T(KC_T)",
            "KC_G",
            "KC_M",
            "LSFT_T(KC_N)",
            "LGUI_T(KC_E)",
            "LALT_T(KC_I)",
            "LCTL_T(KC_A)",
            "XXXXXXX",
            "XXXXXXX",
            "KC_Q",
            "KC_J",
            "KC_V",
            "KC_D",
            "KC_K",
            "KC_X",
            "KC_H",
            "KC_SLSH",
            "KC_COMM",
            "KC_DOT",
            "XXXXXXX",
            "XXXXXXX",
            "LT(2,KC_SPC)",
            "LT(3,KC_ENT)",
            "LSFT_T(KC_BSPC)",
            "LT(1,KC_ESC)",
            "XXXXXXX",
            "XXXXXXX",
            "XXXXXXX"
        ],
        [
            "XXXXXXX",
            "XXXXXXX",
            "XXXXXXX",
            "XXXXXXX",
            "XXXXXXX",
            "XXXXXXX",
            "XXXXXXX",
            "XXXXXXX",
            "XXXXXXX",
            "XXXXXXX",
            "XXXXXXX",
            "XXXXXXX",
            "XXXXXXX",
            "XXXXXXX",
            "KC_P9",
            "KC_P8",
            "KC_P7",
            "XXXXXXX",
            "XXXXXXX",
            "XXXXXXX",
            "XXXXXXX",
            "XXXXXXX",
            "XXXXXXX",
            "XXXXXXX",
            "XXXXXXX",
            "XXXXXXX",
            "KC_P6",
            "KC_P5",
            "KC_P4",
            "XXXXXXX",
            "KC_LEFT",
            "KC_DOWN",
            "KC_UP",
            "KC_RGHT",
            "XXXXXXX",
            "XXXXXXX",
            "XXXXXXX",
            "XXXXXXX",
            "KC_P3",
            "KC_P2",
            "KC_P1",
            "XXXXXXX",
            "XXXXXXX",
            "XXXXXXX",
            "XXXXXXX",
            "XXXXXXX",
            "XXXXXXX",
            "XXXXXXX",
            "XXXXXXX",
            "KC_P0",
            "XXXXXXX",
            "XXXXXXX",
            "XXXXXXX",
            "XXXXXXX",
            "XXXXXXX",
            "XXXXXXX"
        ],
        [
            "XXXXXXX",
            "XXXXXXX",
            "XXXXXXX",
            "XXXXXXX",
            "XXXXXXX",
            "XXXXXXX",
            "XXXXXXX",
            "XXXXXXX",
            "XXXXXXX",
            "XXXXXXX",
            "XXXXXXX",
            "XXXXXXX",
            "XXXXXXX",
            "KC_PERC",
            "KC_LBRC",
            "KC_RBRC",
            "XXXXXXX",
            "KC_AMPR",
            "KC_PDOT",
            "KC_DQUO",
            "KC_LT",
            "KC_GT",
            "KC_QUOT",
            "XXXXXXX",
            "XXXXXXX",
            "KC_QUES",
            "KC_LPRN",
            "KC_RPRN",
            "KC_COLN",
            "KC_PIPE",
            "KC_HASH",
            "KC_PEQL",
            "KC_PPLS",
            "KC_PMNS",
            "KC_EXLM",
            "XXXXXXX",
            "XXXXXXX",
            "KC_AT",
            "KC_LCBR",
            "KC_RCBR",
            "KC_DLR",
            "KC_TILD",
            "XXXXXXX",
            "KC_BSLS",
            "KC_PAST",
            "KC_PSLS",
            "KC_CIRC",
            "XXXXXXX",
            "XXXXXXX",
            "XXXXXXX",
            "XXXXXXX",
            "XXXXXXX",
            "XXXXXXX",
            "XXXXXXX",
            "XXXXXXX",
            "XXXXXXX"
        ],
        [
            "XXXXXXX",
            "XXXXXXX",
            "XXXXXXX",
            "XXXXXXX",
            "XXXXXXX",
            "XXXXXXX",
            "XXXXXXX",
            "XXXXXXX",
            "XXXXXXX",
            "XXXXXXX",
            "XXXXXXX",
            "XXXXXXX",
            "XXXXXXX",
            "XXXXXXX",
            "KC_F7",
            "KC_F8",
            "KC_F9",
            "KC_F12",
            "XXXXXXX",
            "XXXXXXX",
            "XXXXXXX",
            "XXXXXXX",
            "XXXXXXX",
            "XXXXXXX",
            "XXXXXXX",
            "XXXXXXX",
            "KC_F6",
            "KC_F5",
            "KC_F4",
            "KC_F11",
            "XXXXXXX",
            "XXXXXXX",
            "XXXXXXX",
            "XXXXXXX",
            "XXXXXXX",
            "XXXXXXX",
            "XXXXXXX",
            "XXXXXXX",
            "KC_F3",
            "KC_F2",
            "KC_F1",
            "KC_F10",
            "XXXXXXX",
            "XXXXXXX",
            "XXXXXXX",
            "XXXXXXX",
            "XXXXXXX",
            "XXXXXXX",
            "XXXXXXX",
            "XXXXXXX",
            "XXXXXXX",
            "XXXXXXX",
            "XXXXXXX",
            "XXXXXXX",
            "XXXXXXX",
            "XXXXXXX"
        ]
    ],
    "author": ""
}
